C 150,150,255

F 100,000001,100

SO ./texture/SO.xpm
NO ./texture/NO.xpm
WE ./texture/WE.xpm
EA ./texture/EA.xpm




11111111111111111111111111111111
100000000000000000000111111111101
111111111011110001110000000010001
        1001000000000000000001001
111111111011000001110000000000001
100000000011000001110111111111111
11110111111111011100000010001
1111011111111011101000010001
110000001101010111010000100N1
1000000000000001100010010001
10000000000000001100010010001
1100000111010101111101111000111
11110111 1110101 101111010001
11111111 1111111 111111111111

