C	150,          	 150,  				255

F	100,     000001,			100
       
SO						./texture/SO.xpm
NO	      ./texture/NO.xpm
WE	./texture/WE.xpm
EA	./texture/EA.xpm

11111111111111111111111
10S1100111
1010110101
11111111111
