C 169,169,169

F 128,128,128

SO ./../texture/SO.xpm
NO ./../texture/NO.xpm
WE ./../texture/WE.xpm
EA ./../texture/EA.xpm




1111111111111111111111111111111
1000000000000000000000000000001
1000000000000000000000000000001
1000000000000000000000000000001
1000000000000000000000000000001
1000000000000000000000000000001
1000000000000000W00000000000001
1000000000000001210000000000001
1000000000000000000000000000001
1000000000000000000000000000001
1000000000000000000000000000001
1000000000000000000000000000001
1000000000000000000000000000001
1000000000000000000000000000001
1111111111111111111111111111111

  



