C 169,169,169

F 128,128,128

SO ./../texture/SO.xpm
NO ./../texture/NO.xpm
WE ./../texture/WE.xpm
EA ./../texture/EA.xpm




1111111111111111111111111111111
1000000000000000000000000000001
1000000000000000000000000000001
1000000000000000000000000000001
1000000000000000000000000000001
1000000000000000000000000000001
1000000000011001110100000000001
10000000000E0000000000000000001
1000000000000000100000000000001
1000000000000000000000000000001
1000000000000000000000000000001
1000000000000000000000000000001
1000000000000000000000000000001
1000000000000000000000000000001
1111111111111111111111111111111

  



